{
  "grid_size": {
    "x": 10,
    "y": 10
  },
  "tile_size": {
    "x": 16,
    "y": 16
  },
  "layers": [
    {
      "id": "ground",
      "kind": "tile_layer",
      "tiles": [
        0, 34, 34, 0, 0, 0, 0, 0, 0, 0,
        0, 34, 34, 0, 0, 0, 0, 0, 0, 0,
        0, 34, 34, 0, 0, 0, 0, 0, 0, 0,
        0, 34, 34, 0, 0, 0, 0, 0, 0, 0,
        0, 34, 34, 0, 0, 0, 0, 0, 0, 0,
        0, 34, 34, 0, 0, 0, 0, 0, 0, 0,
        0, 34, 34, 0, 0, 0, 0, 0, 0, 0,
        0, 34, 34, 0, 0, 0, 0, 0, 0, 0,
        0, 34, 34, 0, 0, 0, 0, 0, 0, 0,
        0, 34, 34, 0, 0, 0, 0, 0, 0, 0,
        0, 34, 34, 0, 0, 0, 0, 0, 0, 0
      ]
    },
    {
      "id": "barriers",
      "kind": "tile_layer",
      "tiles": [
        51, 0, 0, 49, 0, 0, 0, 0, 0, 0,
        51, 0, 0, 49, 0, 0, 0, 0, 0, 0,
        51, 0, 0, 49, 0, 0, 0, 0, 0, 0,
        51, 0, 0, 49, 0, 0, 0, 0, 0, 0,
        51, 0, 0, 49, 0, 0, 0, 0, 0, 0,
        51, 0, 0, 49, 0, 0, 0, 0, 0, 0,
        51, 0, 0, 49, 0, 0, 0, 0, 0, 0,
        51, 0, 0, 49, 0, 0, 0, 0, 0, 0,
        51, 0, 0, 49, 0, 0, 0, 0, 0, 0,
        51, 0, 0, 49, 0, 0, 0, 0, 0, 0,
        51, 0, 0, 49, 0, 0, 0, 0, 0, 0
      ]
    },
    {
      "id": "solids",
      "kind": "tile_layer",
      "tiles": [
        0, 0, 0, 0, 0, 0, 0, 0, 0, 0,
        0, 0, 0, 0, 0, 0, 0, 0, 0, 0,
        0, 0, 0, 0, 0, 0, 0, 0, 0, 0,
        0, 0, 0, 0, 0, 0, 0, 0, 0, 0,
        0, 0, 0, 0, 0, 0, 0, 0, 0, 0,
        0, 0, 0, 0, 0, 0, 0, 0, 0, 0,
        0, 0, 0, 0, 0, 0, 0, 0, 0, 0,
        0, 0, 0, 0, 0, 0, 0, 0, 0, 0,
        0, 0, 0, 0, 0, 0, 0, 0, 0, 0,
        0, 0, 0, 0, 0, 0, 0, 0, 0, 0,
        0, 0, 0, 0, 0, 0, 0, 0, 0, 0
      ]
    },
    {
      "id": "spawn_points",
      "kind": "object_layer",
      "objects": [
        {
          "id": "player_spawn",
          "position": {
            "x": 100.0,
            "y": 100.0
          }
        }
      ]
    }
  ],
  "tilesets": [
    {
      "id": "ground_tiles",
      "texture_id": "tiles",
      "tile_size": {
        "x": 16,
        "y": 16
      },
      "texture_size": {
        "x": 320,
        "y": 320
      },
      "grid_size": {
        "x": 4,
        "y": 16
      },
      "first_tile_id": 1
    }
  ]
}
