{
  "grid_size": {
    "x": 10,
    "y": 20
  },
  "tile_size": {
    "x": 16,
    "y": 16
  },
  "layers": [
    {
      "id": "ground",
      "kind": "tile_layer",
      "tiles": [
        0, 122, 122, 0, 0, 0, 0, 0, 0, 0,
        0, 122, 122, 0, 0, 0, 0, 0, 0, 0,
        0, 122, 122, 0, 0, 0, 0, 0, 0, 0,
        0, 122, 122, 0, 0, 0, 0, 0, 0, 0,
        0, 122, 122, 0, 0, 0, 0, 0, 0, 0,
        0, 122, 122, 0, 0, 0, 0, 0, 0, 0,
        0, 122, 122, 0, 0, 0, 0, 0, 0, 0,
        0, 122, 122, 0, 0, 0, 0, 0, 0, 0,
        0, 122, 122, 0, 0, 0, 0, 0, 0, 0,
        0, 122, 122, 0, 0, 0, 0, 0, 0, 0,
        0, 122, 122, 0, 0, 0, 0, 0, 0, 0,
        0, 122, 122, 0, 0, 0, 0, 0, 0, 0,
        0, 122, 122, 0, 0, 0, 0, 0, 0, 0,
        0, 122, 122, 0, 0, 0, 0, 0, 0, 0,
        0, 122, 122, 0, 0, 0, 0, 0, 0, 0,
        0, 122, 122, 0, 0, 0, 0, 0, 0, 0,
        0, 122, 122, 0, 0, 0, 0, 0, 0, 0,
        0, 122, 122, 0, 0, 0, 0, 0, 0, 0,
        0, 122, 122, 0, 0, 0, 0, 0, 0, 0,
        0, 122, 122, 0, 0, 0, 0, 0, 0, 0,
        0, 122, 122, 0, 0, 0, 0, 0, 0, 0,
        0, 122, 122, 0, 0, 0, 0, 0, 0, 0
      ]
    },
    {
      "id": "barriers",
      "kind": "tile_layer",
      "tiles": [
        183, 0, 0, 181, 0, 0, 0, 0, 0, 0,
        183, 0, 0, 181, 0, 0, 0, 0, 0, 0,
        183, 0, 0, 181, 0, 0, 0, 0, 0, 0,
        183, 0, 0, 181, 0, 0, 0, 0, 0, 0,
        183, 0, 0, 181, 0, 0, 0, 0, 0, 0,
        183, 0, 0, 181, 0, 0, 0, 0, 0, 0,
        183, 0, 0, 181, 0, 0, 0, 0, 0, 0,
        183, 0, 0, 181, 0, 0, 0, 0, 0, 0,
        183, 0, 0, 181, 0, 0, 0, 0, 0, 0,
        183, 0, 0, 181, 0, 0, 0, 0, 0, 0,
        183, 0, 0, 181, 0, 0, 0, 0, 0, 0,
        183, 0, 0, 181, 0, 0, 0, 0, 0, 0,
        183, 0, 0, 181, 0, 0, 0, 0, 0, 0,
        183, 0, 0, 181, 0, 0, 0, 0, 0, 0,
        183, 0, 0, 181, 0, 0, 0, 0, 0, 0,
        183, 0, 0, 181, 0, 0, 0, 0, 0, 0,
        183, 0, 0, 181, 0, 0, 0, 0, 0, 0,
        183, 0, 0, 181, 0, 0, 0, 0, 0, 0,
        183, 0, 0, 181, 0, 0, 0, 0, 0, 0,
        183, 0, 0, 181, 0, 0, 0, 0, 0, 0,
        183, 0, 0, 181, 0, 0, 0, 0, 0, 0,
        183, 0, 0, 181, 0, 0, 0, 0, 0, 0
      ]
    },
    {
      "id": "solids",
      "kind": "tile_layer",
      "tiles": [
        0, 0, 0, 0, 0, 0, 0, 0, 0, 0,
        0, 0, 0, 0, 0, 0, 0, 0, 0, 0,
        0, 0, 0, 0, 0, 0, 0, 0, 0, 0,
        0, 0, 0, 0, 0, 0, 0, 0, 0, 0,
        0, 0, 0, 0, 0, 0, 0, 0, 0, 0,
        0, 0, 0, 0, 0, 0, 0, 0, 0, 0,
        0, 0, 0, 0, 0, 0, 0, 0, 0, 0,
        0, 0, 0, 0, 0, 0, 0, 0, 0, 0,
        0, 0, 0, 0, 0, 0, 0, 0, 0, 0,
        0, 0, 0, 0, 0, 0, 0, 0, 0, 0,
        0, 0, 0, 0, 0, 0, 0, 0, 0, 0,
        0, 0, 0, 0, 0, 0, 0, 0, 0, 0,
        0, 0, 0, 0, 0, 0, 0, 0, 0, 0,
        0, 0, 0, 0, 0, 0, 0, 0, 0, 0,
        0, 0, 0, 0, 0, 0, 0, 0, 0, 0,
        0, 0, 0, 0, 0, 0, 0, 0, 0, 0,
        0, 0, 0, 0, 0, 0, 0, 0, 0, 0,
        0, 0, 0, 0, 0, 0, 0, 0, 0, 0,
        0, 0, 0, 0, 0, 0, 0, 0, 0, 0,
        0, 0, 0, 0, 0, 0, 0, 0, 0, 0,
        0, 0, 0, 0, 0, 0, 0, 0, 0, 0,
        0, 0, 0, 0, 0, 0, 0, 0, 0, 0
      ]
    },
    {
      "id": "spawn_points",
      "kind": "object_layer",
      "objects": [
        {
          "id": "player_spawn",
          "position": {
            "x": 100.0,
            "y": 100.0
          }
        }
      ]
    }
  ],
  "tilesets": [
    {
      "id": "ground_tiles",
      "texture_id": "tiles",
      "tile_size": {
        "x": 16,
        "y": 16
      },
      "texture_size": {
        "x": 320,
        "y": 320
      },
      "grid_size": {
        "x": 15,
        "y": 20
      },
      "first_tile_id": 1
    },
    {
      "id": "props_tiles",
      "texture_id": "props",
      "tile_size": {
        "x": 16,
        "y": 16
      },
      "texture_size": {
        "x": 160,
        "y": 160
      },
      "grid_size": {
        "x": 10,
        "y": 10
      },
      "first_tile_id": 301
    }
  ]
}
